

1111111
1E10001
10001C1
1110101
1P000C1
1111111


