111111111111111
1011P1E00000001
100101000000001
110101000000001
100000000000001
100C00000000001
100000000000001
100000000000001
111111111111111
